NO ./textures/4.xpm
SO ./textures/3.xpm
WE ./textures/2.xpm
EA ./textures/1.xpm

F 50,25,0
C 135,206,250

1111111111111111111111111
1000000000110000000000001
1011000001110000000000001
1001000000D00000000001111
111111111011000001110D001
1000000000110000011101111
11110111111111011100000101
11000000110101011100000101
10000000000100001100000101
10000000000D00001101010N01
11000001110101011111011101
11110111111111011111111111
1111111111111111111111111
