NO ./textures/iron.xpm
SO ./textures/stone.xpm
WE ./textures/iron.xpm
EA ./textures/stone.xpm

F 64,64,64
C 135,206,250

SP ./textures/sans.xpm ./textures/frisk.xpm ./textures/undyne.xpm ./textures/gaster.xpm

11111111111111111111111111111111
10000000001100000000000000000001
10110000011100000000001111111101
100100000000000X0000001010000101
11111111D111000001110000D00000101
10000000001100000111000010000001
11110111111111011100000010001111
110X0000110101011100000010001001
100000000X00010001100000100001001
10000X0000000D00110000001X00100 X1
110000011101010111110111000010011
11110111 1110101 1011101110N001001
11111111 1111111 1011111111000001
10000000000000000000000000001001
10111111111111111111111111111001
10000000000000000D00000000000001
11111111111111111111111111111111