NO ./textures/4.xpm
SO ./textures/3.xpm
WE ./textures/2.xpm
EA ./textures/1.xpm

F 50,25,0
C 135,206,250

    1111111111111111111111111
    11111111111111111111111111
    1000000W000D0000000111111
    1111100000000000000000001
        100000000001111110011111
11111111111111110000000111111
111111000000000D0000000000111
11111111111111111111111111111