NO ./textures/iron.xpm



SO ./textures/stone.xpm
								WE ./textures/iron.xpm




EA ./textures/stone.xpm

F 64,64,64
C 1		3	5			,					206				,			250

SP ./textures/sprite_1.xpm ./textures/sprite_2.xpm ./textures/sprite_3.xpm ./textures/sprite_4.xpm

111111111111111111111111111111111111111111		
100000000011000000000000000000000000000001
101100000111000000000011111111	 1000000001
100100000000000X0000001010000101100X00X001
11111111D111000001110000D000000D000000X001
10000000001100000111000010000001000X00X01
11110111111111011100000010001111000X00X01
110X0000110101011100000010001001000X00001
1S0000000X00010001100000100001001000000001
10000X0000000D00110000001X00100 111111D11111
11000001110101011111011100001001100X000X011
11010111 1110101 1010101110 0010010X000X00111
11011111 1111111 101011111100000100X000X0111
10000000000000000000000000001001000X000X111
1011111111111111111111111111100D0000000011
10000000000000000D00000000000001000000001111111
11111111111111111111111111111111	0000000001
1111111111111111111111111111111111111111111111
100001100000100000101110100001101110111111111
1011101011111110111011101011101001101		1
1000011000011110111011101000011010101		1
1010111011111110111011101010111011001		1
1011011011111110111011101011011011101		1
1011101011111110111011101011101011101		1	
1011101000001110111100011011101011101		1
111111111111111111111111111111111111111111111
1011101100011100001000001000001000011100001
1001001011101011111110111011111011101011111
1010101011101011111110111000011000011011111
1010101000001100011110111011111010111100011
1011101011101111101110111011111011011111101
1011101011101111101110111011111011101111101
1011101011101000011110111000001011101000011
1111111111111111111111111111111111111111111
11
101
1111