NO ./textures/1.xpm
SO ./textures/2.xpm
WE ./textures/3.xpm
EA ./textures/4.xpm

F 220,100,0
C 135,206,235

11111111111111111111111111111111111
11111111111111111111111000001111111
11111111111111111110000000000000111
11111111111111111110000000000000111
11111111111111111111111000001111111
11111111111111111000000000001111111
11111111111111111000111000001111111
11111111111111111000111000001111111
11111111111111111000111111111111111
11111111111111111N11111111111111111
11111111111111111011111111111111111
11111110000011110011111111111111111
11100000000000000011111111111111111
11100000000000001111111111111111111
11111110000011111111111111111111111
11111110000011111111111111111111111
11111110000011111111111111111111111
11111110000011111111111111111111111
11111111111111111111111111111111111
11111111111111111111111111111111111
