NO ./textures/1.xpm
SO ./textures/2.xpm
WE ./textures/3.xpm
EA ./textures/4.xpm

F 220,100,0
C 135,206,235

11111111111111111111111111111111111
1                                 1
1                                 1
1                                 1
1                                 1
1                                 1
111111                            1
     1                            1
     1                            1
111111                            1
1                                 1
1                                 1
1                                 1
1                                 1
1                   N             1
1                                 1			
1                                 1
1                                 1
1                                 1
1                                 1
1                                 1
1                                 1
1                                 1
1                                 1
1                                 1
11111111111111111111111111111111111