NO ./textures/1.xpm
SO ./textures/2.xpm
WE ./textures/3.xpm
EA ./textures/4.xpm

F 220,100,0
C 135,206,235

11111111111111111111111111111
10000000001000000000000000001
10000000001000000000000000001
1000000000D0000N0000000000001
10000000001000000000000000001
11111111111111111111111111111